XXXXXXXXXXXXXXXXXXXXXXXXXXXXXX
XOOOOOOOOOOOOOOOOOOOOOOOOOOOOX
XOOSOOOOOOOOOOOOOOOOOOOOOOOOOX
XOOOOOOOOOOOOOOOOOOOOOOOOOOOOX
XOOOOOOXXXXXXXXXXXXXXXXOOOOOOX
XOOOOOOOOOXOOOOOOOOOOOOOOOOOOX
XOOOOOOOOOXOOOOOOOOOOOOOOOOOOX
XOOOOOOOOOXOOOOOOOOOOOOOOOOOOX
XOOOOOOOOOXOOOOOOOOOOXOOOOOOOX
XOOOOOOOOOXOOOOOOOOOOXOOOOOOOX
XOOOOOOOOOXOOOOOOOOOOXOOOOOOOX
XOOOOOOOOOOOOOOOOOOOOXOOOOOOOX
XOOOOOOOOOOOOOOOOOOOOXOOOOOOOX
XOOOOOOOOOOOOOOOOOOOOXOOOOOOOX
XOOOOOOOOXXXXXXXXXXXXXOOOOOOOX
XOOOOOOOOOOOOOOOOOOOOXOOOOOOOX
XOOOOOOOOSOOOOOOOOOOOXOOOOOOOX
XOOOOOOOOOOOOOOOOOOOOXOOOOOOOX
XOOOOOXXXXXXXXXXXXXXXXOOOOOOOX
XOOOOOOOOOOOOOOOOOOOOXOOOOOOOX
