XXXXXXXXXXXXXXXXXXXXXXXXXXXXXX
XOOOOOOOOOOOOOOOOOOOOOOOOOOOOX
XOOSOOOOOOOOOOOOOOOOOOOOOOOOOX
XOOOOOOOOOOOOOOOOOOOOOOOOOOOOX
XOOOOOOXXXXXXXXXXXXXXXXOOOOOOX
XOOOOOOOOOXOOOOOOOOOOOOOOOOOOX
XOOOOOOOOOXOOOOOOOOOOOOOOOOOOX
XOOOOOOOOOXOOOOOOOOOOOOOOOOOOX
XOOOOOOOOOXOOOOOOOOOOXOOOOOOOX
XOOOOOOOOOXOOOOOOOOOOXOOOOOOOX
XOOOOOOOOOXOOOOOOOOOOXOOOOOOOX
XOOOOOOOOOOOOOOOOOOOOXOOOOOOOX
XOOOOOOOOOOOOOOOOOOOOXOOOOOOOX
XOOOOOOOOOOOOOOOOOOOOXOOOOOOOX
XOOOOOOOOXXXXXXXXXXXXXOOOOOOOX
XOOOOOOOOOOOOOOOOOOOOXOOOOOOOX
XOOOOOOOOOOOOOOOOOOOOXOOOOOOOX
XOOOOOOOOOOOOOOOOOOOOXOOOOOOOX
XOOOOOXXXXXXXXXXXXXXXXOOOOOOOX
XOOOOOOOOOOOOOOOOOOOOXOOOOOOOX
XOOOOOOOOOOOOOOOOOOOOXXXXXOOOX
XOOOOOOOOXOOOOOOOOOOOXOOOOOOOX
XOOOOOOOOXOOOOOOOOOOOXOOOOOOOX
XOOOOOOOOXOOOOOOOOOOOXOOOOOOOX
XOOOOXXXXXXXXXXXOOOOOOOOOOOOOX
XOOOOOOOOXOOOOOXOOOOOOOOOOOOOX
XOOOOOOOOXOOOOOXOOOOOOOOOOOOOX
XOOOOOOOOOOOOOOOOOOOOOSOOOOOOX
XOOOOOOOOOOOOOOOOOOOOOOOOOOOOX
XXXXXXXXXXXXXXXXXXXXXXXXXXXXXX
